NO ./textures/north.xpm
SO ./textures/south.xpm
WE ./textures/west.xpm
EA ./textures/east.xpm

F 220,100,0
C 100,150,250

1111111111111
1000000000001
1011000000001
10010000000001
1000S000000001
10000000000001
10000000000001
11111110111111
10000000000001
10000000000001
10000000000001
10000000000001
11111111111111
